'	っ
,	、
-	ー
.	。
;'	ざい
;,	ぞう
;.	ぜい
;a	ざ
;c	じょつ
;e	ぜ
;g	じょう
;h'	じゃい
;h,	じょう
;h.	じぇい
;ha	じゃ
;he	じぇ
;hi	じぃ
;hj	じぇん
;hk	じゅん
;ho	じょ
;hp	じゅう
;hq	じょん
;ht'	じゃく
;ht,	じょく
;ht.	じぇき
;hta	じゃつ
;hte	じぇつ
;hti	じぃつ
;htj	じぇっ
;htk	じゅっ
;hto	じょつ
;htp	じゅく
;htq	じょっ
;htu	じゅつ
;htx	じぃっ
;hty	じぃき
;htz	じゃっ
;hu	じゅ
;hx	じぃん
;hy	じゅい
;hz	じゃん
;i	じ
;j	ぜん
;k	ずん
;m	じゅう
;o	ぞ
;p	ずう
;q	ぞん
;r	じょく
;t'	ざく
;t,	ぞく
;t.	ぜき
;ta	ざつ
;te	ぜつ
;ti	じつ
;tj	ぜっ
;tk	ずっ
;to	ぞつ
;tp	ずく
;tq	ぞっ
;tu	ずつ
;tx	じっ
;ty	じき
;tz	ざっ
;u	ず
;v	じゅく
;w	じゅつ
;x	じん
;y	ずい
;z	ざん
='	ぁい
=,	ぉう
=.	ぇい
=a	ぁ
=ca	ヵ
=ce	ヶ
=e	ぇ
=i	ぃ
=j	ぇん
=k	ぅん
=o	ぉ
=p	ぅう
=q	ぉん
=t'	ぁく
=t,	ぉく
=t.	ぇき
=ta	ぁつ
=te	ぇつ
=ti	ぃつ
=tj	ぇっ
=tk	ぅっ
=to	ぉつ
=tp	ぅく
=tq	ぉっ
=tu	っ
=tx	ぃっ
=ty	ぃき
=tz	ぁっ
=u	ぅ
=v'	ゃい
=v,	ょう
=v.	ぃぇい
=va	ゃ
=ve	ぃぇ
=vi	ぃ
=vj	ぃぇん
=vk	ゅん
=vo	ょ
=vp	ゅう
=vq	ょん
=vt'	ゃく
=vt,	ょく
=vt.	ぃぇき
=vta	ゃつ
=vte	ぃぇつ
=vti	ぃつ
=vtj	ぃぇっ
=vtk	ゅっ
=vto	ょつ
=vtp	ゅく
=vtq	ょっ
=vtu	ゅつ
=vtx	ぃっ
=vty	ぃき
=vtz	ゃっ
=vu	ゅ
=vx	ぃん
=vy	ゅい
=vz	ゃん
=wa	ゎ
=x	ぃん
=y	ぅい
=z	ぁん
[	「
]	」
a	あ
b'	ばい
b,	ぼう
b.	べい
ba	ば
bc	びょつ
be	べ
bg	びょく
bi	び
bj	べん
bk	ぶん
bm	びゅく
bn'	びゃい
bn,	びょう
bn.	びぇい
bna	びゃ
bne	びぇ
bni	びぃ
bnj	びぇん
bnk	びゅん
bno	びょ
bnp	びゅう
bnq	びょん
bnt'	びゃく
bnt,	びょく
bnt.	びぇき
bnta	びゃつ
bnte	びぇつ
bnti	びぃつ
bntj	びぇっ
bntk	びゅっ
bnto	びょつ
bntp	びゅく
bntq	びょっ
bntu	びゅつ
bntx	びぃっ
bnty	びぃき
bntz	びゃっ
bnu	びゅ
bnx	びぃん
bny	びゅい
bnz	びゃん
bo	ぼ
bp	ぶう
bq	ぼん
br	びょう
bt'	ばく
bt,	ぼく
bt.	べき
bta	ばつ
bte	べつ
bti	びつ
btj	べっ
btk	ぶっ
bto	ぼつ
btp	ぶく
btq	ぼっ
btu	ぶつ
btx	びっ
bty	びき
btz	ばっ
bu	ぶ
bv	びゅう
bw	びゅつ
bx	びん
by	ぶい
bz	ばん
c'	かい
c,	こう
c.	けい
ca	か
cc	きょつ
ce	け
cg	きょう
ch'	きゃい
ch,	きょう
ch.	きぇい
cha	きゃ
che	きぇ
chi	きぃ
chj	きぇん
chk	きゅん
cho	きょ
chp	きゅう
chq	きょん
cht'	きゃく
cht,	きょく
cht.	きぇき
chta	きゃつ
chte	きぇつ
chti	きぃつ
chtj	きぇっ
chtk	きゅっ
chto	きょつ
chtp	きゅく
chtq	きょっ
chtu	きゅつ
chtx	きぃっ
chty	きぃき
chtz	きゃっ
chu	きゅ
chx	きぃん
chy	きゅい
chz	きゃん
ci	き
cj	けん
ck	くん
cm	きゅう
cn'	くぁい
cn,	くぉう
cn.	くぇい
cna	くぁ
cne	くぇ
cni	くぃ
cnj	くぇん
cnk	くぅん
cno	くぉ
cnp	くぅう
cnq	くぉん
cnt'	くぁく
cnt,	くぉく
cnt.	くぇき
cnta	くぁつ
cnte	くぇつ
cnti	くぃつ
cntj	くぇっ
cntk	くぅっ
cnto	くぉつ
cntp	くぅく
cntq	くぉっ
cntu	くぅつ
cntx	くぃっ
cnty	くぃき
cntz	くぁっ
cnu	くぅ
cnx	くぃん
cny	くぅい
cnz	くぁん
co	こ
cp	くう
cq	こん
cr	きょく
ct'	かく
ct,	こく
ct.	けき
cta	かつ
cte	けつ
cti	きつ
ctj	けっ
ctk	くっ
cto	こつ
ctp	くく
ctq	こっ
ctu	くつ
ctx	きっ
cty	きき
ctz	かっ
cu	く
cv	きゅく
cw	きゅつ
cx	きん
cy	くい
cz	かん
d'	だい
d,	どう
d.	でい
da	だ
dc	ぢょつ
de	で
dg	ぢょく
dh'	でゃい
dh,	でょう
dh.	でぇい
dha	でゃ
dhe	でぇ
dhi	でぃ
dhj	でぇん
dhk	でゅん
dho	でょ
dhp	でゅう
dhq	でょん
dht'	でゃく
dht,	でょく
dht.	でぇき
dhta	でゃつ
dhte	でぇつ
dhti	でぃつ
dhtj	でぇっ
dhtk	でゅっ
dhto	でょつ
dhtp	でゅく
dhtq	でょっ
dhtu	でゅつ
dhtx	でぃっ
dhty	でぃき
dhtz	でゃっ
dhu	でゅ
dhx	でぃん
dhy	でゅい
dhz	でゃん
di	ぢ
dj	でん
dk	づん
dm	ぢゅく
dn'	ぢゃい
dn,	ぢょう
dn.	ぢぇい
dna	ぢゃ
dne	ぢぇ
dni	ぢぃ
dnj	ぢぇん
dnk	ぢゅん
dno	ぢょ
dnp	ぢゅう
dnq	ぢょん
dnt'	ぢゃく
dnt,	ぢょく
dnt.	ぢぇき
dnta	ぢゃつ
dnte	ぢぇつ
dnti	ぢぃつ
dntj	ぢぇっ
dntk	ぢゅっ
dnto	ぢょつ
dntp	ぢゅく
dntq	ぢょっ
dntu	ぢゅつ
dntx	ぢぃっ
dnty	ぢぃき
dntz	ぢゃっ
dnu	ぢゅ
dnx	ぢぃん
dny	ぢゅい
dnz	ぢゃん
do	ど
dp	づう
dq	どん
dr	ぢょう
ds'	どぁい
ds,	どぉう
ds.	どぇい
dsa	どぁ
dse	どぇ
dsi	どぃ
dsj	どぇん
dsk	どぅん
dso	どぉ
dsp	どぅう
dsq	どぉん
dst'	どぁく
dst,	どぉく
dst.	どぇき
dsta	どぁつ
dste	どぇつ
dsti	どぃつ
dstj	どぇっ
dstk	どぅっ
dsto	どぉつ
dstp	どぅく
dstq	どぉっ
dstu	どぅつ
dstx	どぃっ
dsty	どぃき
dstz	どぁっ
dsu	どぅ
dsx	どぃん
dsy	どぅい
dsz	どぁん
dt'	だく
dt,	どく
dt.	でき
dta	だつ
dte	でつ
dti	ぢつ
dtj	でっ
dtk	づっ
dto	どつ
dtp	づく
dtq	どっ
dtu	づつ
dtx	ぢっ
dty	ぢき
dtz	だっ
du	づ
dv	ぢゅう
dw	ぢゅつ
dx	ぢん
dy	づい
dz	だん
e	え
f'	ぱい
f,	ぽう
f.	ぺい
fa	ぱ
fc	ぴょつ
fe	ぺ
fg	ぴょく
fi	ぴ
fj	ぺん
fk	ぷん
fm	ぴゅく
fn'	ぴゃい
fn,	ぴょう
fn.	ぴぇい
fna	ぴゃ
fne	ぴぇ
fni	ぴぃ
fnj	ぴぇん
fnk	ぴゅん
fno	ぴょ
fnp	ぴゅう
fnq	ぴょん
fnt'	ぴゃく
fnt,	ぴょく
fnt.	ぴぇき
fnta	ぴゃつ
fnte	ぴぇつ
fnti	ぴぃつ
fntj	ぴぇっ
fntk	ぴゅっ
fnto	ぴょつ
fntp	ぴゅく
fntq	ぴょっ
fntu	ぴゅつ
fntx	ぴぃっ
fnty	ぴぃき
fntz	ぴゃっ
fnu	ぴゅ
fnx	ぴぃん
fny	ぴゅい
fnz	ぴゃん
fo	ぽ
fp	ぷう
fq	ぽん
fr	ぴょう
ft'	ぱく
ft,	ぽく
ft.	ぺき
fta	ぱつ
fte	ぺつ
fti	ぴつ
ftj	ぺっ
ftk	ぷっ
fto	ぽつ
ftp	ぷく
ftq	ぽっ
ftu	ぷつ
ftx	ぴっ
fty	ぴき
ftz	ぱっ
fu	ぷ
fv	ぴゅう
fw	ぴゅつ
fx	ぴん
fy	ぷい
fz	ぱん
g'	がい
g,	ごう
g.	げい
ga	が
gc	ぎょつ
ge	げ
gg	ぎょく
gh'	ぐぁい
gh,	ぐぉう
gh.	ぐぇい
gha	ぐぁ
ghe	ぐぇ
ghi	ぐぃ
ghj	ぐぇん
ghk	ぐぅん
gho	ぐぉ
ghp	ぐぅう
ghq	ぐぉん
ght'	ぐぁく
ght,	ぐぉく
ght.	ぐぇき
ghta	ぐぁつ
ghte	ぐぇつ
ghti	ぐぃつ
ghtj	ぐぇっ
ghtk	ぐぅっ
ghto	ぐぉつ
ghtp	ぐぅく
ghtq	ぐぉっ
ghtu	ぐぅつ
ghtx	ぐぃっ
ghty	ぐぃき
ghtz	ぐぁっ
ghu	ぐぅ
ghx	ぐぃん
ghy	ぐぅい
ghz	ぐぁん
gi	ぎ
gj	げん
gk	ぐん
gm	ぎゅく
gn'	ぎゃい
gn,	ぎょう
gn.	ぎぇい
gna	ぎゃ
gne	ぎぇ
gni	ぎぃ
gnj	ぎぇん
gnk	ぎゅん
gno	ぎょ
gnp	ぎゅう
gnq	ぎょん
gnt'	ぎゃく
gnt,	ぎょく
gnt.	ぎぇき
gnta	ぎゃつ
gnte	ぎぇつ
gnti	ぎぃつ
gntj	ぎぇっ
gntk	ぎゅっ
gnto	ぎょつ
gntp	ぎゅく
gntq	ぎょっ
gntu	ぎゅつ
gntx	ぎぃっ
gnty	ぎぃき
gntz	ぎゃっ
gnu	ぎゅ
gnx	ぎぃん
gny	ぎゅい
gnz	ぎゃん
go	ご
gp	ぐう
gq	ごん
gr	ぎょう
gt'	がく
gt,	ごく
gt.	げき
gta	がつ
gte	げつ
gti	ぎつ
gtj	げっ
gtk	ぐっ
gto	ごつ
gtp	ぐく
gtq	ごっ
gtu	ぐつ
gtx	ぎっ
gty	ぎき
gtz	がっ
gu	ぐ
gv	ぎゅう
gw	ぎゅつ
gx	ぎん
gy	ぐい
gz	がん
h'	はい
h,	ほう
h.	へい
ha	は
hc	ひょつ
he	へ
hg	ひょく
hh'	ふぁい
hh,	ふぉう
hh.	ふぇい
hha	ふぁ
hhe	ふぇ
hhi	ふぃ
hhj	ふぇん
hhk	ふぅん
hho	ふぉ
hhp	ふぅう
hhq	ふぉん
hht'	ふぁく
hht,	ふぉく
hht.	ふぇき
hhta	ふぁつ
hhte	ふぇつ
hhti	ふぃつ
hhtj	ふぇっ
hhtk	ふぅっ
hhto	ふぉつ
hhtp	ふぅく
hhtq	ふぉっ
hhtu	ふぅつ
hhtx	ふぃっ
hhty	ふぃき
hhtz	ふぁっ
hhu	ふぅ
hhx	ふぃん
hhy	ふぅい
hhz	ふぁん
hi	ひ
hj	へん
hk	ふん
hm	ひゅく
hn'	ひゃい
hn,	ひょう
hn.	ひぇい
hna	ひゃ
hne	ひぇ
hni	ひぃ
hnj	ひぇん
hnk	ひゅん
hno	ひょ
hnp	ひゅう
hnq	ひょん
hnt'	ひゃく
hnt,	ひょく
hnt.	ひぇき
hnta	ひゃつ
hnte	ひぇつ
hnti	ひぃつ
hntj	ひぇっ
hntk	ひゅっ
hnto	ひょつ
hntp	ひゅく
hntq	ひょっ
hntu	ひゅつ
hntx	ひぃっ
hnty	ひぃき
hntz	ひゃっ
hnu	ひゅ
hnx	ひぃん
hny	ひゅい
hnz	ひゃん
ho	ほ
hp	ふう
hq	ほん
hr	ひょう
ht'	はく
ht,	ほく
ht.	へき
hta	はつ
hte	へつ
hti	ひつ
htj	へっ
htk	ふっ
hto	ほつ
htp	ふく
htq	ほっ
htu	ふつ
htx	ひっ
hty	ひき
htz	はっ
hu	ふ
hv	ひゅう
hw	ひゅつ
hx	ひん
hy	ふい
hz	はん
i	い
j	えん
k	うん
l.	しました
lc	削除
le	します
lh	確認
lj	しまして
lk	でして
lp	でした
lt	変更
lu	です
m'	まい
m,	もう
m.	めい
ma	ま
mc	みょつ
me	め
mg	みょく
mi	み
mj	めん
mk	むん
mm	みゅく
mn'	みゃい
mn,	みょう
mn.	みぇい
mna	みゃ
mne	みぇ
mni	みぃ
mnj	みぇん
mnk	みゅん
mno	みょ
mnp	みゅう
mnq	みょん
mnt'	みゃく
mnt,	みょく
mnt.	みぇき
mnta	みゃつ
mnte	みぇつ
mnti	みぃつ
mntj	みぇっ
mntk	みゅっ
mnto	みょつ
mntp	みゅく
mntq	みょっ
mntu	みゅつ
mntx	みぃっ
mnty	みぃき
mntz	みゃっ
mnu	みゅ
mnx	みぃん
mny	みゅい
mnz	みゃん
mo	も
mp	むう
mq	もん
mr	みょう
mt'	まく
mt,	もく
mt.	めき
mta	まつ
mte	めつ
mti	みつ
mtj	めっ
mtk	むっ
mto	もつ
mtp	むく
mtq	もっ
mtu	むつ
mtx	みっ
mty	みき
mtz	まっ
mu	む
mv	みゅう
mw	みゅつ
mx	みん
my	むい
mz	まん
n'	ない
n,	のう
n.	ねい
na	な
nc	にょつ
ne	ね
ng	にょう
nh'	にゃい
nh,	にょう
nh.	にぇい
nha	にゃ
nhe	にぇ
nhi	にぃ
nhj	にぇん
nhk	にゅん
nho	にょ
nhp	にゅう
nhq	にょん
nht'	にゃく
nht,	にょく
nht.	にぇき
nhta	にゃつ
nhte	にぇつ
nhti	にぃつ
nhtj	にぇっ
nhtk	にゅっ
nhto	にょつ
nhtp	にゅく
nhtq	にょっ
nhtu	にゅつ
nhtx	にぃっ
nhty	にぃき
nhtz	にゃっ
nhu	にゅ
nhx	にぃん
nhy	にゅい
nhz	にゃん
ni	に
nj	ねん
nk	ぬん
nm	にゅう
nn	ん
no	の
np	ぬう
nq	のん
nr	にょく
nt'	なく
nt,	のく
nt.	ねき
nta	なつ
nte	ねつ
nti	につ
ntj	ねっ
ntk	ぬっ
nto	のつ
ntp	ぬく
ntq	のっ
ntu	ぬつ
ntx	にっ
nty	にき
ntz	なっ
nu	ぬ
nv	にゅく
nw	にゅつ
nx	にん
ny	ぬい
nz	なん
o	お
p	ー
q	おん
r'	らい
r,	ろう
r.	れい
ra	ら
rc	りょつ
re	れ
rg	りょう
rh'	りゃい
rh,	りょう
rh.	りぇい
rha	りゃ
rhe	りぇ
rhi	りぃ
rhj	りぇん
rhk	りゅん
rho	りょ
rhp	りゅう
rhq	りょん
rht'	りゃく
rht,	りょく
rht.	りぇき
rhta	りゃつ
rhte	りぇつ
rhti	りぃつ
rhtj	りぇっ
rhtk	りゅっ
rhto	りょつ
rhtp	りゅく
rhtq	りょっ
rhtu	りゅつ
rhtx	りぃっ
rhty	りぃき
rhtz	りゃっ
rhu	りゅ
rhx	りぃん
rhy	りゅい
rhz	りゃん
ri	り
rj	れん
rk	るん
rm	りゅう
ro	ろ
rp	るう
rq	ろん
rr	りょく
rt'	らく
rt,	ろく
rt.	れき
rta	らつ
rte	れつ
rti	りつ
rtj	れっ
rtk	るっ
rto	ろつ
rtp	るく
rtq	ろっ
rtu	るつ
rtx	りっ
rty	りき
rtz	らっ
ru	る
rv	りゅく
rw	りゅつ
rx	りん
ry	るい
rz	らん
s'	さい
s,	そう
s.	せい
sa	さ
sc	しょつ
se	せ
sg	しょう
sh'	しゃい
sh,	しょう
sh.	しぇい
sha	しゃ
she	しぇ
shi	しぃ
shj	しぇん
shk	しゅん
sho	しょ
shp	しゅう
shq	しょん
sht'	しゃく
sht,	しょく
sht.	しぇき
shta	しゃつ
shte	しぇつ
shti	しぃつ
shtj	しぇっ
shtk	しゅっ
shto	しょつ
shtp	しゅく
shtq	しょっ
shtu	しゅつ
shtx	しぃっ
shty	しぃき
shtz	しゃっ
shu	しゅ
shx	しぃん
shy	しゅい
shz	しゃん
si	し
sj	せん
sk	すん
sm	しゅう
so	そ
sp	すう
sq	そん
sr	しょく
st'	さく
st,	そく
st.	せき
sta	さつ
ste	せつ
sti	しつ
stj	せっ
stk	すっ
sto	そつ
stp	すく
stq	そっ
stu	すつ
stx	しっ
sty	しき
stz	さっ
su	す
sv	しゅく
sw	しゅつ
sx	しん
sy	すい
sz	さん
t'	たい
t,	とう
t.	てい
ta	た
tc	ちょつ
te	て
tg	ちょう
th'	ちゃい
th,	ちょう
th.	ちぇい
tha	ちゃ
the	ちぇ
thi	ちぃ
thj	ちぇん
thk	ちゅん
tho	ちょ
thp	ちゅう
thq	ちょん
tht'	ちゃく
tht,	ちょく
tht.	ちぇき
thta	ちゃつ
thte	ちぇつ
thti	ちぃつ
thtj	ちぇっ
thtk	ちゅっ
thto	ちょつ
thtp	ちゅく
thtq	ちょっ
thtu	ちゅつ
thtx	ちぃっ
thty	ちぃき
thtz	ちゃっ
thu	ちゅ
thx	ちぃん
thy	ちゅい
thz	ちゃん
ti	ち
tj	てん
tk	つん
tm	ちゅう
tn'	てゃい
tn,	てょう
tn.	てぇい
tna	てゃ
tne	てぇ
tni	てぃ
tnj	てぇん
tnk	てゅん
tno	てょ
tnp	てゅう
tnq	てょん
tnt'	てゃく
tnt,	てょく
tnt.	てぇき
tnta	てゃつ
tnte	てぇつ
tnti	てぃつ
tntj	てぇっ
tntk	てゅっ
tnto	てょつ
tntp	てゅく
tntq	てょっ
tntu	てゅつ
tntx	てぃっ
tnty	てぃき
tntz	てゃっ
tnu	てゅ
tnx	てぃん
tny	てゅい
tnz	てゃん
to	と
tp	つう
tq	とん
tr	ちょく
ts'	とぁい
ts,	とぉう
ts.	とぇい
tsa	とぁ
tse	とぇ
tsi	とぃ
tsj	とぇん
tsk	とぅん
tso	とぉ
tsp	とぅう
tsq	とぉん
tst'	とぁく
tst,	とぉく
tst.	とぇき
tsta	とぁつ
tste	とぇつ
tsti	とぃつ
tstj	とぇっ
tstk	とぅっ
tsto	とぉつ
tstp	とぅく
tstq	とぉっ
tstu	とぅつ
tstx	とぃっ
tsty	とぃき
tstz	とぁっ
tsu	とぅ
tsx	とぃん
tsy	とぅい
tsz	とぁん
tt'	たく
tt,	とく
tt.	てき
tta	たつ
tte	てつ
tti	ちつ
ttj	てっ
ttk	つっ
tto	とつ
ttp	つく
ttq	とっ
ttu	つつ
ttx	ちっ
tty	ちき
ttz	たっ
tu	つ
tv	ちゅく
tw	ちゅつ
tx	ちん
ty	つい
tz	たん
u	う
v'	やい
v,	よう
v.	いぇい
va	や
ve	いぇ
vi	い
vj	いぇん
vk	ゆん
vo	よ
vp	ゆう
vq	よん
vt'	やく
vt,	よく
vt.	いぇき
vta	やつ
vte	いぇつ
vti	いつ
vtj	いぇっ
vtk	ゆっ
vto	よつ
vtp	ゆく
vtq	よっ
vtu	ゆつ
vtx	いっ
vty	いき
vtz	やっ
vu	ゆ
vv'	ゔぁい
vv,	ゔぉう
vv.	ゔぇい
vva	ゔぁ
vve	ゔぇ
vvi	ゔぃ
vvj	ゔぇん
vvk	ゔん
vvo	ゔぉ
vvp	ゔう
vvq	ゔぉん
vvt'	ゔぁく
vvt,	ゔぉく
vvt.	ゔぇき
vvta	ゔぁつ
vvte	ゔぇつ
vvti	ゔぃつ
vvtj	ゔぇっ
vvtk	ゔっ
vvto	ゔぉつ
vvtp	ゔく
vvtq	ゔぉっ
vvtu	ゔつ
vvtx	ゔぃっ
vvty	ゔぃき
vvtz	ゔぁっ
vvu	ゔ
vvx	ゔぃん
vvy	ゔい
vvz	ゔぁん
vx	いん
vy	ゆい
vz	やん
w'	わい
w,	をう
w.	うぇい
wa	わ
we	うぇ
wh'	うぁい
wh,	うぉう
wh.	うぇい
wha	うぁ
whe	うぇ
whi	うぃ
whj	うぇん
whk	うん
who	うぉ
whp	うう
whq	うぉん
wht'	うぁく
wht,	うぉく
wht.	うぇき
whta	うぁつ
whte	うぇつ
whti	うぃつ
whtj	うぇっ
whtk	うっ
whto	うぉつ
whtp	うく
whtq	うぉっ
whtu	うつ
whtx	うぃっ
whty	うぃき
whtz	うぁっ
whu	う
whx	うぃん
why	うい
whz	うぁん
wi	うぃ
wj	うぇん
wk	うん
wo	を
wp	うう
wq	をん
wt'	わく
wt,	をく
wt.	うぇき
wta	わつ
wte	うぇつ
wti	うぃつ
wtj	うぇっ
wtk	うっ
wto	をつ
wtp	うく
wtq	をっ
wtu	うつ
wtx	うぃっ
wty	うぃき
wtz	わっ
wu	う
wx	うぃん
wy	うい
wz	わん
x	いん
y,	‥
y-	〜
y.	…
y/	・
y[	『
y]	』
yd	←
yh	↓
yn	→
yp	〜
yt	↑
z	あん
~	〜
